3,92,17,21,98,73,11,3,85,69,98,3,7,96,4,84,20,3,4,5,109,109,10,4,4,105,105,48,12,7,3,75,84,84,188,11,9,3,20,20,16,44,3,3,4,100,101,53,3,4,3,4,97,3,4,90,17,18,14,17,3,86,18,3,3,4,12,18,14,35,71,3,3,58,101,18,55,3,14,3,17,22,14,22,18,3,3,17,18,3,17,18,3,12,
4,93,18,22,99,74,12,4,86,70,99,4,8,97,5,85,21,4,5,6,110,110,11,5,5,106,106,49,13,8,4,76,85,85,189,12,4,21,21,17,45,4,4,5,101,102,54,4,5,4,5,98,4,5,91,20,19,15,18,4,87,19,4,4,5,13,19,18,36,72,4,4,59,103,19,56,4,15,4,20,23,15,23,19,4,4,20,19,4,20,19,4,13,
5,94,19,23,100,75,13,5,100,71,100,5,9,98,6,86,22,5,6,7,111,111,12,6,6,107,107,50,14,9,5,77,86,86,190,13,5,22,22,18,46,5,5,6,102,103,55,5,6,5,6,99,5,6,92,24,20,19,22,5,88,20,5,5,6,14,20,19,37,73,5,5,60,104,20,57,5,16,5,24,24,19,24,20,5,5,24,20,5,24,20,5,14,
6,95,20,24,101,76,14,6,101,72,101,6,10,99,7,87,23,6,7,8,112,112,13,15,7,108,108,51,15,10,6,78,87,87,191,14,6,23,23,19,47,6,6,7,103,104,56,6,7,6,7,100,6,7,93,25,21,20,25,6,89,21,6,6,7,17,21,20,38,74,6,6,61,105,21,58,6,17,6,25,25,20,25,21,6,6,25,21,6,25,21,6,17,
7,96,21,25,102,77,15,7,102,73,102,7,11,100,8,88,24,14,8,9,113,113,14,19,8,109,109,52,16,7,88,88,88,15,7,24,24,20,48,7,7,8,104,105,57,7,8,7,8,101,7,8,94,27,22,21,26,7,90,22,7,7,8,20,22,21,39,75,7,7,62,106,22,59,7,18,7,27,28,21,26,22,7,7,27,22,7,27,22,7,20,
8,97,22,26,103,78,16,8,103,74,103,8,12,101,9,89,25,19,9,10,114,114,15,20,9,110,110,53,17,8,89,89,89,16,8,25,25,21,49,8,8,9,105,106,58,8,9,8,9,102,8,9,95,28,24,22,35,8,91,29,8,8,9,23,23,22,40,76,8,8,63,109,29,60,8,19,8,28,29,22,35,29,8,8,28,29,15,28,29,8,43,
85,98,83,27,104,79,84,89,104,104,104,78,102,62,90,86,99,112,115,115,115,84,84,111,111,54,77,78,90,90,90,63,26,26,26,23,50,32,38,106,107,59,103,85,111,103,86,35,96,66,25,23,57,51,92,103,111,86,59,66,24,23,41,77,33,102,64,110,103,61,70,20,85,75,30,23,57,103,70,85,75,103,58,66,103,86,44,
