459,13,4,161,4,9,4,4,6,5,6,4,17,42,72,41,7,7,67,35,104,72,71,73,66,
460,14,5,162,5,10,5,5,7,6,7,5,18,44,74,42,8,8,68,36,108,73,72,74,67,
461,15,6,163,6,11,6,6,8,7,8,6,19,45,75,43,9,9,70,37,109,74,74,75,68,
462,16,7,176,7,18,7,7,9,8,9,7,20,46,76,45,10,10,71,38,110,75,75,76,69,
472,17,8,177,8,19,8,8,10,9,10,8,21,47,77,46,11,11,72,39,111,76,76,77,70,
473,18,9,178,9,20,9,9,11,10,11,9,22,48,79,47,12,12,73,41,112,78,77,78,71,
38,23,56,44,82,25,109,49,80,48,114,74,42,113,79,78,79,73,
