9,47,4,5,38,3,5,6,206,184,7,3,4,25,5,148,20,24,10,5,214,7,4803,3,3,45,3,51,3,3,
10,48,5,6,45,4,10,7,207,185,8,4,5,26,6,149,21,26,11,6,215,8,4868,4,4,46,4,52,4,4,
11,49,6,7,47,5,13,8,194,15,5,6,30,7,150,22,27,12,7,218,9,4933,5,5,47,5,53,5,5,
12,50,7,48,6,15,9,209,16,6,7,8,151,13,8,219,10,4998,6,6,48,6,54,6,6,
13,51,8,49,17,10,210,17,7,8,9,152,14,222,11,5063,58,7,49,7,55,7,7,
14,52,9,52,81,217,18,8,9,10,153,15,223,12,5128,59,8,50,8,56,8,8,
5292,88,92,245,5193,101,96,51,94,103,94,94,
