776,3,4,3,88,90,71,88,91,86,88,90,90,91,87,93,86,90,92,83,87,87,89,90,90,93,86,90,92,93,87,90,90,93,86,90,92,93,87,90,90,90,90,87,90,90,88,92,90,90,90,90,90,90,90,90,90,90,90,90,90,90,78,86,62,69,69,86,62,86,90,86,88,62,87,86,82,83,87,82,78,88,62,86,78,86,88,86,86,88,86,83,88,88,62,66,88,86,86,88,86,86,77,50,86,90,86,87,83,66,90,86,86,69,87,62,62,62,87,86,59,90,86,86,63,90,90,86,62,86,91,82,88,77,87,88,68,78,62,90,87,71,89,92,86,93,79,86,65,86,90,86,89,75,60,86,92,83,90,69,97,91,60,62,63,89,86,88,89,66,89,83,62,92,88,71,92,86,90,88,86,86,88,69,75,86,86,86,87,62,88,87,86,86,90,69,90,86,88,63,86,86,89,83,86,75,79,87,86,69,87,86,86,86,62,86,78,75,86,62,75,62,78,86,86,86,59,71,71,66,82,83,86,65,80,87,79,73,89,90,87,87,69,90,90,90,90,64,87,85,81,86,90,73,81,86,87,87,86,87,86,86,78,89,88,92,86,86,88,86,86,86,62,86,86,86,86,88,86,88,71,86,86,86,66,69,86,86,86,87,87,75,88,88,62,86,71,75,82,88,86,86,86,83,87,75,86,86,62,86,86,62,90,86,74,78,86,87,78,87,86,92,86,59,86,87,75,86,89,87,81,92,86,92,62,87,69,87,87,59,82,90,69,91,87,87,92,92,74,59,90,87,87,87,87,89,81,92,93,86,81,89,92,91,90,92,64,79,86,83,87,69,90,86,69,91,86,79,92,86,75,69,88,87,74,78,59,86,59,86,86,88,90,88,80,74,86,89,74,62,62,71,92,
777,4,5,4,89,91,72,89,93,87,89,91,91,92,89,95,87,92,93,84,88,88,90,91,91,94,87,92,93,94,88,91,91,94,87,91,93,94,88,91,91,92,91,88,92,91,89,93,91,91,92,91,92,91,91,91,91,91,91,92,91,92,79,87,63,70,70,87,63,87,91,87,89,63,89,87,83,84,88,83,84,89,63,87,79,87,89,87,87,89,87,84,89,89,63,67,89,87,87,89,87,87,78,51,87,91,87,88,84,70,91,87,87,70,88,63,63,63,88,87,60,91,87,87,64,91,91,87,63,87,92,83,89,78,88,89,69,79,63,91,88,72,90,93,87,94,80,87,66,87,91,87,90,76,61,87,93,84,91,70,100,92,61,63,64,90,87,89,90,67,90,90,63,93,89,72,93,87,91,89,87,88,89,70,76,87,87,87,88,63,89,89,87,87,91,70,91,87,89,64,87,87,90,84,87,76,80,88,87,70,88,87,87,87,63,87,79,76,87,63,76,63,79,87,87,87,60,72,72,67,83,91,87,66,81,88,80,74,90,91,88,88,70,91,91,91,91,65,88,86,82,88,91,74,82,87,88,90,87,88,88,87,79,90,89,93,87,87,89,87,87,87,63,87,87,87,87,89,87,89,72,87,87,87,67,70,87,87,87,89,88,76,91,89,63,87,72,76,83,89,87,87,87,87,88,76,87,87,63,87,87,63,91,87,75,79,87,88,79,89,87,93,87,63,87,88,76,87,91,88,82,93,87,93,63,88,70,88,89,63,83,92,70,92,88,88,93,93,75,63,91,88,88,88,88,90,82,93,94,87,82,90,93,92,92,93,65,80,87,87,88,70,91,87,70,94,87,80,93,87,76,70,89,88,75,79,63,87,60,87,87,89,91,89,81,75,87,91,75,63,63,72,93,
778,5,6,5,90,92,73,90,94,88,90,92,92,93,90,96,88,93,94,85,89,89,91,92,92,95,88,93,94,95,89,93,92,95,88,92,94,95,89,92,92,93,92,89,93,92,90,94,92,92,93,93,93,92,92,92,92,93,93,93,92,93,80,88,64,71,71,88,64,88,92,88,90,64,90,88,84,85,89,84,85,90,64,88,85,88,90,88,88,90,88,85,90,90,64,68,90,88,89,90,88,88,79,52,88,92,88,89,85,71,92,88,88,71,89,64,64,64,89,88,61,92,88,88,65,92,92,88,64,88,93,84,90,79,89,92,70,80,64,92,89,73,91,94,88,95,81,88,67,88,92,88,91,77,62,88,95,85,92,71,101,93,62,64,65,91,88,91,91,68,91,92,64,94,90,73,94,88,93,90,88,89,90,71,77,88,88,88,90,64,90,90,88,88,92,71,92,88,90,65,88,89,91,85,88,77,81,89,88,71,90,88,88,88,64,88,85,77,89,64,77,64,80,88,88,88,61,73,73,68,84,92,88,67,82,89,81,76,91,92,89,89,71,92,92,92,92,66,89,87,83,89,92,75,83,88,89,91,88,89,89,88,80,92,90,94,88,88,90,88,88,88,64,88,88,88,88,90,88,90,73,88,88,88,68,71,88,88,88,90,89,77,92,90,64,88,73,77,84,90,88,88,88,88,89,77,88,88,64,88,88,64,92,88,76,80,88,89,80,90,88,94,88,64,88,89,77,88,92,89,83,94,88,94,64,91,71,91,90,64,84,93,71,93,89,91,94,94,76,64,92,89,89,89,89,91,84,94,95,88,83,91,94,93,93,94,66,81,89,88,89,71,92,88,73,95,88,81,94,88,77,71,92,89,76,80,64,88,61,88,88,90,92,90,82,76,88,92,76,64,64,73,94,
779,6,7,6,91,93,74,91,89,93,93,93,94,91,97,89,94,95,86,90,90,92,93,93,96,89,94,95,96,90,94,93,96,89,93,95,96,90,93,93,94,90,94,93,93,95,93,93,94,94,94,93,93,93,93,94,94,94,93,94,81,89,65,72,72,89,65,89,93,89,91,65,91,89,85,86,90,85,86,91,65,89,86,89,91,89,89,91,89,86,91,91,65,69,91,89,90,91,89,89,80,53,89,93,89,90,86,74,93,89,89,72,90,65,65,65,90,90,62,93,89,89,66,93,89,65,89,94,86,91,80,90,93,71,81,65,93,90,74,92,97,90,96,82,90,68,89,93,89,92,78,63,89,96,86,93,72,102,94,63,65,66,92,89,92,92,69,92,93,65,95,91,74,95,89,94,91,89,90,91,72,78,89,89,89,91,65,91,91,89,89,93,72,93,89,91,66,89,90,92,86,89,78,82,90,89,72,91,89,89,89,65,89,86,78,90,65,78,65,81,89,89,89,62,74,74,69,85,93,89,68,83,90,82,77,92,93,90,90,72,93,93,93,93,67,90,88,84,91,94,76,84,89,90,92,89,90,91,89,81,93,93,95,89,89,91,89,89,89,65,89,89,89,89,91,89,91,74,89,89,89,69,72,89,89,89,91,90,78,93,91,65,90,74,78,85,93,89,89,89,89,90,78,89,89,65,89,89,65,93,89,77,81,89,90,81,91,89,95,89,65,89,92,78,89,93,90,84,95,90,95,65,92,72,92,91,65,86,94,72,94,90,92,95,95,77,65,94,90,90,90,90,92,85,95,96,89,84,92,95,95,94,95,67,82,90,89,90,72,93,89,74,100,89,82,95,89,78,72,93,90,77,81,65,89,62,89,89,91,93,91,83,77,89,93,77,65,65,74,95,
780,7,8,7,92,94,75,92,90,94,94,95,95,92,98,90,95,98,87,91,91,93,94,95,97,90,95,98,97,91,95,95,97,90,94,98,97,91,94,95,95,91,95,95,94,98,94,94,95,95,95,94,94,94,94,95,95,95,94,95,82,90,66,73,73,90,66,90,94,90,92,66,92,90,86,87,91,86,87,92,66,90,87,90,92,90,90,92,90,87,92,92,66,70,92,90,91,92,90,90,81,54,90,94,90,92,87,75,94,90,90,73,92,66,66,66,91,91,63,94,90,90,67,95,90,66,90,95,87,92,81,91,94,72,82,66,94,91,75,93,98,91,97,83,91,69,90,94,90,93,79,64,90,97,87,94,73,103,95,64,66,67,93,90,93,93,70,93,94,66,98,92,75,98,90,95,92,90,91,92,73,79,90,90,90,92,66,92,92,90,90,94,73,94,90,92,67,90,91,93,87,90,79,83,91,90,73,92,90,90,90,66,90,87,79,91,66,79,66,82,90,90,90,63,75,75,70,87,94,90,69,84,91,83,78,93,94,91,91,73,94,94,95,94,68,91,89,85,92,95,77,85,90,91,93,90,93,92,90,82,94,94,98,90,90,92,90,90,90,66,90,90,90,90,92,90,94,75,90,90,90,70,73,90,90,90,92,91,79,94,92,66,91,75,79,86,94,90,90,90,90,91,79,90,90,66,90,90,66,94,90,78,82,90,91,82,92,90,96,90,66,90,93,79,90,94,91,85,98,91,98,66,93,73,93,92,66,87,95,73,95,91,93,98,98,78,66,95,91,91,91,91,93,86,98,97,90,85,93,98,96,95,98,68,84,91,90,91,73,95,90,75,101,90,83,96,90,79,73,94,91,78,82,66,90,63,90,90,92,95,92,84,78,90,94,78,66,66,75,96,
781,8,9,8,93,95,76,93,91,95,95,96,96,94,99,91,96,99,88,92,92,94,95,96,98,91,98,99,98,92,96,96,98,91,95,99,98,92,95,96,96,92,96,96,95,99,95,95,96,96,96,95,95,95,95,96,96,96,95,104,83,91,67,74,74,91,67,91,95,91,95,67,93,91,87,88,92,87,88,93,67,91,88,91,93,91,91,94,91,88,93,95,67,71,93,91,92,93,91,91,82,55,91,95,91,93,88,76,95,91,91,74,93,67,67,67,92,92,64,95,91,91,68,96,91,67,96,99,93,82,92,95,73,83,67,95,92,76,94,99,93,98,84,92,70,91,95,91,94,80,65,92,98,88,95,74,104,97,65,67,68,94,91,95,94,71,94,95,67,99,93,76,99,91,96,93,91,92,93,74,80,91,91,91,93,67,93,93,91,91,95,74,95,91,93,68,91,92,94,88,91,80,87,92,91,74,93,91,91,91,67,91,88,80,92,67,80,67,83,91,91,91,64,76,76,71,88,95,91,70,85,92,84,79,94,95,92,92,74,95,95,96,95,69,92,90,86,93,96,78,86,91,92,95,91,94,93,91,83,95,95,99,91,91,93,91,91,91,67,91,91,91,91,93,91,95,76,91,91,91,71,74,91,91,91,93,92,80,95,93,67,93,76,80,87,95,91,91,91,91,92,80,91,91,67,91,91,67,95,91,79,83,91,92,83,93,92,97,91,67,91,94,80,91,95,92,86,99,92,99,67,94,74,94,93,67,88,96,74,97,92,94,99,99,79,67,96,92,92,92,92,94,87,99,99,91,86,94,99,97,96,99,69,85,93,91,94,74,96,91,76,102,91,84,99,91,84,74,95,93,79,83,67,91,64,91,91,93,96,93,85,79,91,95,79,67,67,76,99,
811,87,96,78,94,96,77,94,92,103,96,97,97,95,106,92,99,100,89,93,93,95,96,97,99,92,99,100,99,93,97,97,99,92,97,100,99,93,96,97,97,93,99,97,96,100,96,97,97,99,99,96,97,97,96,99,104,97,97,105,88,92,68,75,75,92,68,92,96,92,96,68,94,92,88,89,93,88,89,94,68,92,89,92,94,92,92,96,92,89,94,96,68,72,94,92,93,94,92,92,83,56,92,96,92,94,89,77,96,92,92,75,94,68,68,68,94,93,65,96,92,92,69,97,92,68,98,100,96,83,95,96,74,84,68,96,93,77,95,100,94,99,85,93,71,92,96,92,95,81,66,93,99,89,96,75,105,98,66,68,69,95,93,96,95,72,95,96,68,100,94,77,100,92,97,94,92,94,94,75,81,92,92,92,94,68,94,94,92,92,96,75,96,92,94,69,92,93,95,90,92,81,88,93,92,75,94,92,92,92,68,92,89,81,93,68,81,68,84,92,92,92,65,77,77,72,89,97,92,71,86,93,85,80,95,96,93,93,75,96,96,97,96,70,93,91,87,94,97,79,87,92,93,96,92,95,94,92,84,96,96,100,92,93,96,92,92,92,68,92,92,92,92,94,92,96,80,92,92,92,72,75,92,92,92,94,94,81,96,94,68,94,77,81,88,96,92,92,92,92,93,81,92,92,68,92,92,68,96,92,80,84,92,93,89,94,93,98,92,68,92,95,81,92,96,93,87,100,93,100,68,96,75,96,94,68,92,98,75,98,93,96,100,100,80,68,97,93,93,93,93,95,88,100,100,92,87,95,100,98,98,100,70,86,94,92,95,75,97,92,77,103,92,85,100,92,88,75,96,94,81,84,68,92,65,92,92,94,97,94,86,80,92,97,80,68,68,77,100,
