7,246,5,89,89,89,89,15,7,8,4,7,68,202,4,4,425,523,635,519,361,5,5,4,4,5,420,3,505,423,3,387,387,5,548,4,399,387,5,377,417,546,4,392,355,387,421,387,3,4,
8,247,6,90,90,90,90,16,8,9,5,8,69,203,5,5,426,524,638,520,362,6,6,5,5,6,421,4,545,425,4,388,388,8,549,5,400,388,6,378,418,547,5,425,361,420,472,388,4,5,
9,248,7,91,91,91,91,17,9,10,6,9,70,204,6,6,427,525,639,521,363,7,7,6,6,8,423,5,546,426,5,421,389,9,551,6,406,421,7,379,419,588,6,426,362,421,473,389,5,6,
12,249,8,92,92,92,92,18,10,11,7,10,71,207,7,7,428,526,678,522,403,8,8,7,7,9,424,6,548,462,6,422,390,10,552,7,407,422,8,380,420,589,7,427,363,422,489,390,6,7,
16,250,9,93,93,93,93,19,11,12,8,11,72,216,8,8,429,529,679,524,404,9,9,8,8,10,469,7,549,463,7,423,391,12,593,8,408,423,9,381,421,595,8,428,399,423,529,391,7,8,
17,251,10,94,94,94,94,20,12,13,9,12,73,217,9,9,430,530,680,525,405,10,10,9,9,18,470,8,589,503,8,424,434,13,594,9,436,424,10,424,422,596,9,430,405,425,531,392,8,9,
86,66,95,95,95,95,88,291,93,431,569,682,565,407,91,555,85,471,590,505,436,426,435,427,600,403,438,426,425,423,635,431,406,426,532,435,419,
