4,5,5,117,479,7,3,103,3,317,11,11,8,4,3,73,4,86,68,75,67,3,106,32,71,67,3,32,84,67,3,32,93,67,3,32,86,67,3,32,88,67,3,32,63,60,86,3,32,3,61,51,67,3,68,63,32,63,3,32,63,3,32,63,3,78,32,69,59,79,75,3,32,63,3,32,63,61,77,60,95,60,80,3,68,72,32,63,68,91,3,68,75,72,32,63,3,68,72,32,63,68,3,68,75,78,63,32,63,3,68,79,32,45,3,68,79,32,63,3,68,79,32,63,3,68,79,32,63,3,68,79,32,63,3,32,63,3,32,63,3,32,63,3,32,63,3,32,63,78,3,32,63,60,93,61,88,61,93,60,86,60,95,3,60,51,78,68,3,32,63,67,94,3,78,68,75,72,32,63,3,68,32,63,3,32,63,3,68,68,75,32,73,3,32,63,59,71,60,93,68,95,69,93,60,88,61,93,69,86,69,95,3,59,51,75,3,68,32,63,59,93,75,3,68,68,32,93,3,63,68,32,63,3,68,79,68,68,63,32,63,3,68,68,32,73,75,3,68,63,32,63,3,68,63,63,32,63,3,68,32,93,3,68,68,68,63,32,63,3,68,72,68,75,63,32,63,68,3,68,32,63,75,3,63,32,63,3,68,32,63,68,83,69,63,3,32,63,75,3,32,63,60,87,69,95,3,67,63,68,61,83,
5,6,6,118,480,8,4,104,4,318,12,12,9,5,4,74,5,87,69,76,68,4,107,33,72,68,4,33,85,68,4,33,94,68,4,33,87,68,4,33,89,68,4,33,64,62,87,4,33,4,62,52,68,4,69,64,33,64,4,33,64,4,33,64,4,79,33,70,60,80,77,4,33,64,4,33,64,62,78,62,96,62,81,4,69,80,33,64,69,92,4,69,77,80,33,64,4,69,80,33,64,69,4,69,77,79,64,33,64,4,69,80,33,46,4,69,80,33,64,4,69,80,33,64,4,69,80,33,64,4,69,80,33,64,4,33,64,4,33,64,4,33,64,4,33,64,4,33,64,79,4,33,64,61,94,62,89,62,94,61,87,61,96,4,62,52,79,69,4,33,64,68,95,4,79,69,77,80,33,64,4,69,33,64,4,33,64,4,69,69,77,33,74,4,33,64,60,72,62,94,69,96,70,94,61,89,62,94,70,87,70,96,4,60,52,77,4,69,33,64,60,94,77,4,69,69,33,94,4,64,69,33,64,4,69,80,69,69,64,33,64,4,69,69,33,74,77,4,69,64,33,64,4,69,64,64,33,64,4,69,33,94,4,69,69,69,64,33,64,4,69,80,69,77,64,33,64,69,4,69,33,64,77,4,64,33,64,4,69,33,64,69,84,70,64,4,33,64,77,4,33,64,62,88,70,96,4,68,64,69,62,84,
6,7,7,119,9,14,105,5,319,13,13,10,6,5,75,6,88,70,77,69,5,108,34,73,69,5,34,86,69,5,34,95,69,5,34,88,69,5,34,90,69,5,34,65,63,88,5,34,5,63,53,69,5,70,65,34,65,5,34,65,5,34,65,5,80,34,71,62,81,80,5,34,65,5,34,65,64,79,63,97,63,82,5,70,81,34,65,70,93,5,70,80,81,34,65,5,70,81,34,65,70,5,70,80,80,65,34,65,5,70,81,34,47,5,70,81,34,65,5,70,81,34,65,5,70,81,34,65,5,70,81,34,65,5,34,65,5,34,65,5,34,65,5,34,65,5,34,65,80,5,34,65,63,95,63,90,64,95,63,88,63,97,5,63,53,80,70,5,34,65,69,96,5,80,70,80,81,34,65,5,70,34,65,5,34,65,5,70,70,80,34,75,5,34,65,61,73,63,95,70,97,71,95,63,90,63,95,71,88,71,97,5,61,53,80,5,70,34,65,62,95,80,5,70,70,34,95,5,65,70,34,65,5,70,81,70,70,65,34,65,5,70,70,34,75,80,5,70,65,34,65,5,70,65,65,34,65,5,70,34,95,5,70,70,70,65,34,65,5,70,81,70,80,65,34,65,70,5,70,34,65,80,5,65,34,65,5,70,34,65,85,71,65,5,34,65,80,5,34,65,63,89,127,97,5,69,65,70,63,85,
7,8,8,120,15,106,6,320,14,14,11,7,6,76,7,89,71,81,70,6,109,35,74,70,6,35,87,70,6,35,96,70,6,35,89,70,6,35,91,70,6,35,66,64,89,6,35,6,64,54,70,6,71,66,35,66,6,35,66,6,35,66,6,81,35,72,63,82,81,6,35,66,6,35,66,65,80,64,98,64,83,6,71,82,35,66,71,94,6,71,81,82,35,66,6,71,82,35,66,72,6,71,81,81,66,35,66,6,71,82,35,48,6,71,82,35,66,6,71,82,35,66,6,71,82,35,66,6,71,82,35,66,6,35,66,6,35,66,6,35,66,6,35,66,6,35,66,81,6,35,66,64,96,65,91,65,96,64,89,64,98,6,64,54,81,71,6,35,66,70,97,6,81,71,81,82,35,66,6,71,35,66,6,35,66,6,71,71,81,35,76,6,35,66,63,74,64,96,71,98,72,96,64,91,65,96,89,98,6,63,54,81,6,71,35,66,63,96,81,6,71,71,35,96,6,66,71,35,66,6,71,82,71,71,66,35,66,6,71,71,35,76,81,6,71,66,35,66,6,71,66,66,35,66,6,71,35,96,6,71,71,71,66,35,66,6,71,82,71,81,66,35,66,71,6,71,35,66,81,6,66,35,66,6,71,35,66,86,72,66,6,35,66,81,6,35,66,64,90,128,98,6,70,66,71,65,86,
8,9,9,121,22,107,7,321,15,31,12,8,7,77,8,90,72,82,71,7,110,36,75,71,7,36,88,71,7,36,97,71,7,36,90,71,7,36,92,71,7,36,67,65,90,7,36,7,65,55,71,7,72,67,36,67,7,36,67,7,36,67,7,82,36,73,64,83,82,7,36,67,7,36,67,66,81,65,99,65,84,7,72,83,36,67,72,95,7,72,82,83,36,67,7,72,83,36,67,73,7,72,82,82,67,36,67,7,72,83,36,49,7,72,83,36,67,7,72,83,36,67,7,72,83,36,67,7,72,83,36,67,7,36,67,7,36,67,7,36,67,7,36,67,7,36,67,82,7,36,67,65,97,66,92,66,97,65,90,65,99,7,65,55,82,72,7,36,67,98,7,82,72,82,83,36,67,7,72,36,67,7,36,67,7,72,72,82,36,77,7,36,67,64,75,65,97,72,99,73,97,65,92,66,97,90,99,7,64,55,82,7,72,36,67,64,97,82,7,72,72,36,97,7,67,72,36,67,7,72,83,73,72,67,36,67,7,72,72,36,77,82,7,72,67,36,67,7,72,67,67,36,67,7,72,36,97,7,72,72,72,67,36,67,7,73,83,72,82,67,36,67,72,7,72,36,67,82,7,67,36,67,7,73,36,67,87,73,67,7,36,67,82,7,36,67,65,91,129,99,7,67,72,66,87,
9,10,10,23,108,8,322,16,32,13,9,8,78,9,91,73,83,72,8,114,37,76,72,8,37,89,72,8,37,98,72,8,37,91,72,8,37,93,72,8,37,68,67,91,8,37,8,66,56,72,8,73,68,37,68,8,37,68,8,37,68,8,83,37,74,65,84,83,8,37,68,8,37,68,67,82,67,100,67,85,8,73,84,37,68,73,96,8,73,83,84,37,68,8,74,84,37,68,74,8,73,83,83,68,37,68,8,73,84,37,50,8,73,84,37,68,8,73,84,37,68,8,73,84,37,68,8,73,84,37,68,8,37,68,8,37,68,8,37,68,8,37,68,8,37,68,83,8,37,68,66,98,67,93,67,98,66,91,66,100,8,67,56,83,73,8,37,68,99,8,83,73,83,84,37,68,8,73,37,68,8,37,68,8,73,73,83,37,78,8,37,68,65,76,67,98,74,100,74,98,66,93,67,98,91,100,8,65,56,83,8,73,37,68,65,98,83,8,73,73,37,98,8,68,73,37,68,8,73,84,74,73,68,37,68,8,73,73,37,78,83,8,73,68,37,68,8,73,68,68,37,68,8,73,37,98,8,74,73,73,68,37,68,8,74,84,73,83,68,37,68,73,8,73,37,68,83,8,68,37,68,8,74,37,68,88,74,68,8,37,68,83,8,37,68,67,92,130,100,8,68,73,67,88,
74,109,112,381,89,80,75,71,79,69,92,74,84,74,85,115,77,74,85,90,74,85,68,99,74,85,68,92,74,85,94,74,85,92,68,92,69,134,72,67,57,74,85,74,69,68,91,85,87,85,100,85,84,68,108,67,85,84,71,66,87,85,68,100,68,83,68,102,68,86,85,74,85,100,74,97,85,74,84,85,100,85,75,85,67,80,75,85,74,84,84,69,100,85,74,85,51,71,74,85,68,103,85,74,85,69,100,85,74,85,100,85,74,85,131,100,71,68,100,71,68,83,71,100,85,68,82,71,100,84,71,68,100,68,99,68,94,69,99,67,92,67,101,69,68,57,84,74,85,68,100,100,85,84,74,84,85,100,69,74,130,100,85,67,100,85,74,74,84,79,85,100,66,77,68,99,75,101,75,99,68,94,68,99,92,101,72,66,57,84,69,74,68,100,67,99,84,71,74,74,68,99,85,69,74,67,100,85,74,85,75,74,69,100,71,74,74,67,79,84,71,75,69,68,100,71,74,69,69,68,82,85,75,99,85,75,74,74,69,66,100,71,75,85,74,84,69,100,74,85,74,66,95,84,71,69,68,100,71,75,66,87,89,75,69,85,68,91,84,71,74,100,68,93,131,101,72,86,75,68,89,
